province,Item,country,confirmed,deaths,active,date,lat,lon,Población
Mexico,193,Mexico,258990,37359,221631,07/01/2021,19.5,-99.72,8490806
Morelos,194,Mexico,34406,3575,30831,07/01/2021,18.68,-99.1,2065014
Ciudad de Mexico,195,Mexico,683409,34674,648735,07/01/2021,19.43,-99.13,3836506
Colima,196,Mexico,12342,1221,11121,07/01/2021,19.12,-104.01,797245
Puebla,197,Mexico,86325,12271,74054,07/01/2021,19.04,-98.21,6664764
Nayarit,198,Mexico,12704,1873,10831,07/01/2021,21.75,-104.85,1306145
Sinaloa,199,Mexico,42398,6405,35993,07/01/2021,25.17,-107.48,3181609
Aguascalientes,200,Mexico,26770,2469,24301,07/01/2021,21.89,-102.29,1453452
Oaxaca,201,Mexico,48516,3960,44556,07/01/2021,17.07,-96.73,4165619
Campeche,202,Mexico,11689,1306,10383,07/01/2021,19.83,-90.53,1017011
Veracruz,203,Mexico,65108,10139,54969,07/01/2021,19.17,-96.13,1395545
Coahuila,204,Mexico,69604,6414,63190,07/01/2021,27.06,-101.71,9003827
Yucatan,205,Mexico,46549,4205,42344,07/01/2021,20.71,-89.09,8588469
Durango,206,Mexico,34738,2498,32240,07/01/2021,24.56,-104.66,1884622
Baja California Sur,207,Mexico,39272,1529,37743,07/01/2021,26.04,-111.67,821059
Quintana Roo,208,Mexico,32616,3015,29601,07/01/2021,19.18,-88.48,1761389
Baja California,209,Mexico,50697,8728,41969,07/01/2021,30.84,-115.28,3690160
Sonora,210,Mexico,79456,6775,72681,07/01/2021,29.3,-110.33,3111119
Michoacan,211,Mexico,49268,5977,43291,07/01/2021,19.57,-101.71,8490806
San Luis Potosi,212,Mexico,65470,5443,60027,07/01/2021,22.16,-100.99,1761389
Chiapas,213,Mexico,12302,1666,10636,07/01/2021,16.76,-93.13,5812375
Tamaulipas,214,Mexico,65269,5230,60039,07/01/2021,24.27,-98.84,3679623
Queretaro,215,Mexico,69764,4468,65296,07/01/2021,20.59,-100.39,6664764
Guerrero,216,Mexico,41862,4557,37305,07/01/2021,17.44,-99.55,3668973
Nuevo Leon,217,Mexico,127141,9738,117403,07/01/2021,25.59,-100,1306145
Zacatecas,218,Mexico,31100,2836,28264,07/01/2021,22.77,-102.58,1677911
Tlaxcala,219,Mexico,20184,2563,17621,07/01/2021,19.31,-98.24,1395545
Guanajuato,220,Mexico,132987,11114,121873,07/01/2021,21.02,-101.26,6280645
Chihuahua,221,Mexico,57752,7553,50199,07/01/2021,28.63,-106.07,3836506
Hidalgo,222,Mexico,39573,6285,33288,07/01/2021,20.09,-98.76,3121355
Tabasco,223,Mexico,76102,4276,71826,07/01/2021,17.84,-92.62,2599658
Jalisco,224,Mexico,88801,12681,76120,07/01/2021,20.66,-103.35,8490806
Sonora,225,Mexico,79692,6780,72912,07/02/2021,29.3,-110.33,3111119
Sinaloa,226,Mexico,42638,6416,36222,07/02/2021,25.17,-107.48,3181609
Morelos,227,Mexico,34444,3578,30866,07/02/2021,18.68,-99.1,2065014
Queretaro,228,Mexico,69801,4469,65332,07/02/2021,20.59,-100.39,6664764
Chiapas,229,Mexico,12320,1666,10654,07/02/2021,16.76,-93.13,5812375
Baja California Sur,230,Mexico,39658,1536,38122,07/02/2021,26.04,-111.67,821059
Zacatecas,231,Mexico,31116,2835,28281,07/02/2021,22.77,-102.58,1677911
Guerrero,232,Mexico,41925,4560,37365,07/02/2021,17.44,-99.55,3668973
Puebla,233,Mexico,86399,12290,74109,07/02/2021,19.04,-98.21,6664764
Baja California,234,Mexico,50756,8735,42021,07/02/2021,30.84,-115.28,3690160
Campeche,235,Mexico,11810,1308,10502,07/02/2021,19.83,-90.53,1017011
Quintana Roo,236,Mexico,32940,3027,29913,07/02/2021,19.18,-88.48,1761389
Veracruz,237,Mexico,65406,10172,55234,07/02/2021,19.17,-96.13,1395545
Jalisco,238,Mexico,88957,12687,76270,07/02/2021,20.66,-103.35,8490806
Yucatan,239,Mexico,46922,4217,42705,07/02/2021,20.71,-89.09,8588469
Hidalgo,240,Mexico,39617,6286,33331,07/02/2021,20.09,-98.76,3121355
Tamaulipas,241,Mexico,65543,5270,60273,07/02/2021,24.27,-98.84,3679623
Oaxaca,242,Mexico,48620,3963,44657,07/02/2021,17.07,-96.73,4165619
Nayarit,243,Mexico,12751,1873,10878,07/02/2021,21.75,-104.85,1306145
Tabasco,244,Mexico,76510,4280,72230,07/02/2021,17.84,-92.62,2599658
Mexico,245,Mexico,259451,37376,222075,07/02/2021,19.5,-99.72,8490806
Guanajuato,246,Mexico,133055,11116,121939,07/02/2021,21.02,-101.26,6280645
Nuevo Leon,247,Mexico,127361,9741,117620,07/02/2021,25.59,-100,1306145
Michoacan,248,Mexico,49304,5984,43320,07/02/2021,19.57,-101.71,8490806
Ciudad de Mexico,249,Mexico,685240,34696,650544,07/02/2021,19.43,-99.13,3836506
Coahuila,250,Mexico,69635,6419,63216,07/02/2021,27.06,-101.71,9003827
Chihuahua,251,Mexico,57805,7567,50238,07/02/2021,28.63,-106.07,3836506
Colima,252,Mexico,12355,1221,11134,07/02/2021,19.12,-104.01,797245
Durango,253,Mexico,34757,2499,32258,07/02/2021,24.56,-104.66,1884622
Tlaxcala,254,Mexico,20185,2565,17620,07/02/2021,19.31,-98.24,1395545
San Luis Potosi,255,Mexico,65518,5445,60073,07/02/2021,22.16,-100.99,1761389
Aguascalientes,256,Mexico,26778,2470,24308,07/02/2021,21.89,-102.29,1453452
Baja California Sur,257,Mexico,40031,1553,38478,07/03/2021,26.04,-111.67,821059
Queretaro,258,Mexico,69837,4469,65368,07/03/2021,20.59,-100.39,6664764
Mexico,259,Mexico,259913,37408,222505,07/03/2021,19.5,-99.72,8490806
Nuevo Leon,260,Mexico,127566,9760,117806,07/03/2021,25.59,-100,1306145
Chiapas,261,Mexico,12353,1667,10686,07/03/2021,16.76,-93.13,5812375
Zacatecas,262,Mexico,31138,2836,28302,07/03/2021,22.77,-102.58,1677911
Guerrero,263,Mexico,41977,4561,37416,07/03/2021,17.44,-99.55,3668973
Tlaxcala,264,Mexico,20193,2566,17627,07/03/2021,19.31,-98.24,1395545
Sinaloa,265,Mexico,42907,6427,36480,07/03/2021,25.17,-107.48,3181609
Jalisco,266,Mexico,89103,12707,76396,07/03/2021,20.66,-103.35,8490806
San Luis Potosi,267,Mexico,65581,5446,60135,07/03/2021,22.16,-100.99,1761389
Oaxaca,268,Mexico,48737,3967,44770,07/03/2021,17.07,-96.73,4165619
Nayarit,269,Mexico,12784,1875,10909,07/03/2021,21.75,-104.85,1306145
Guanajuato,270,Mexico,133102,11118,121984,07/03/2021,21.02,-101.26,6280645
Ciudad de Mexico,271,Mexico,686968,34708,652260,07/03/2021,19.43,-99.13,3836506
Aguascalientes,272,Mexico,26793,2470,24323,07/03/2021,21.89,-102.29,1453452
Morelos,273,Mexico,34465,3580,30885,07/03/2021,18.68,-99.1,2065014
Sonora,274,Mexico,79931,6790,73141,07/03/2021,29.3,-110.33,3111119
Campeche,275,Mexico,11898,1313,10585,07/03/2021,19.83,-90.53,1017011
Tamaulipas,276,Mexico,65848,5275,60573,07/03/2021,24.27,-98.84,3679623
Tabasco,277,Mexico,76968,4284,72684,07/03/2021,17.84,-92.62,2599658
Chihuahua,278,Mexico,57839,7569,50270,07/03/2021,28.63,-106.07,3836506
Quintana Roo,279,Mexico,33345,3036,30309,07/03/2021,19.18,-88.48,1761389
Baja California,280,Mexico,50812,8736,42076,07/03/2021,30.84,-115.28,3690160
Colima,281,Mexico,12386,1222,11164,07/03/2021,19.12,-104.01,797245
Michoacan,282,Mexico,49349,5988,43361,07/03/2021,19.57,-101.71,8490806
Yucatan,283,Mexico,47295,4228,43067,07/03/2021,20.71,-89.09,8588469
Durango,284,Mexico,34790,2499,32291,07/03/2021,24.56,-104.66,1884622
Hidalgo,285,Mexico,39650,6286,33364,07/03/2021,20.09,-98.76,3121355
Puebla,286,Mexico,86427,12297,74130,07/03/2021,19.04,-98.21,6664764
Coahuila,287,Mexico,69683,6420,63263,07/03/2021,27.06,-101.71,9003827
Veracruz,288,Mexico,65681,10187,55494,07/03/2021,19.17,-96.13,1395545
Sonora,289,Mexico,80160,6793,73367,07/04/2021,29.3,-110.33,3111119
Zacatecas,290,Mexico,31146,2836,28310,07/04/2021,22.77,-102.58,1677911
Veracruz,291,Mexico,65947,10199,55748,07/04/2021,19.17,-96.13,1395545
Tlaxcala,292,Mexico,20203,2567,17636,07/04/2021,19.31,-98.24,1395545
Campeche,293,Mexico,11988,1315,10673,07/04/2021,19.83,-90.53,1017011
Colima,294,Mexico,12420,1222,11198,07/04/2021,19.12,-104.01,797245
Tabasco,295,Mexico,77354,4291,73063,07/04/2021,17.84,-92.62,2599658
San Luis Potosi,296,Mexico,65707,5448,60259,07/04/2021,22.16,-100.99,1761389
Aguascalientes,297,Mexico,26813,2470,24343,07/04/2021,21.89,-102.29,1453452
Sinaloa,298,Mexico,43162,6433,36729,07/04/2021,25.17,-107.48,3181609
Mexico,299,Mexico,260381,37431,222950,07/04/2021,19.5,-99.72,8490806
Durango,300,Mexico,34816,2501,32315,07/04/2021,24.56,-104.66,1884622
Michoacan,301,Mexico,49380,5989,43391,07/04/2021,19.57,-101.71,8490806
Puebla,302,Mexico,86476,12312,74164,07/04/2021,19.04,-98.21,6664764
Queretaro,303,Mexico,69888,4469,65419,07/04/2021,20.59,-100.39,6664764
Chiapas,304,Mexico,12400,1678,10722,07/04/2021,16.76,-93.13,5812375
Guanajuato,305,Mexico,133139,11115,122024,07/04/2021,21.02,-101.26,6280645
Hidalgo,306,Mexico,39690,6288,33402,07/04/2021,20.09,-98.76,3121355
Chihuahua,307,Mexico,57884,7567,50317,07/04/2021,28.63,-106.07,3836506
Nayarit,308,Mexico,12835,1879,10956,07/04/2021,21.75,-104.85,1306145
Jalisco,309,Mexico,89215,12707,76508,07/04/2021,20.66,-103.35,8490806
Baja California Sur,310,Mexico,40404,1565,38839,07/04/2021,26.04,-111.67,821059
Baja California,311,Mexico,50874,8736,42138,07/04/2021,30.84,-115.28,3690160
Ciudad de Mexico,312,Mexico,688847,34735,654112,07/04/2021,19.43,-99.13,3836506
Coahuila,313,Mexico,69700,6423,63277,07/04/2021,27.06,-101.71,9003827
Nuevo Leon,314,Mexico,127758,9767,117991,07/04/2021,25.59,-100,1306145
Morelos,315,Mexico,34496,3580,30916,07/04/2021,18.68,-99.1,2065014
Tamaulipas,316,Mexico,66101,5292,60809,07/04/2021,24.27,-98.84,3679623
Oaxaca,317,Mexico,48821,3975,44846,07/04/2021,17.07,-96.73,4165619
Yucatan,318,Mexico,47607,4237,43370,07/04/2021,20.71,-89.09,8588469
Quintana Roo,319,Mexico,33593,3042,30551,07/04/2021,19.18,-88.48,1761389
Guerrero,320,Mexico,42024,4563,37461,07/04/2021,17.44,-99.55,3668973
Coahuila,321,Mexico,69742,6426,63316,07/05/2021,27.06,-101.71,9003827
Sonora,322,Mexico,80340,6801,73539,07/05/2021,29.3,-110.33,3111119
Guerrero,323,Mexico,42101,4564,37537,07/05/2021,17.44,-99.55,3668973
Tamaulipas,324,Mexico,66377,5305,61072,07/05/2021,24.27,-98.84,3679623
Tabasco,325,Mexico,77743,4296,73447,07/05/2021,17.84,-92.62,2599658
Durango,326,Mexico,34841,2501,32340,07/05/2021,24.56,-104.66,1884622
Chihuahua,327,Mexico,57924,7570,50354,07/05/2021,28.63,-106.07,3836506
Aguascalientes,328,Mexico,26817,2470,24347,07/05/2021,21.89,-102.29,1453452
Hidalgo,329,Mexico,39736,6288,33448,07/05/2021,20.09,-98.76,3121355
Chiapas,330,Mexico,12455,1679,10776,07/05/2021,16.76,-93.13,5812375
Puebla,331,Mexico,86540,12317,74223,07/05/2021,19.04,-98.21,6664764
Tlaxcala,332,Mexico,20209,2568,17641,07/05/2021,19.31,-98.24,1395545
Zacatecas,333,Mexico,31148,2836,28312,07/05/2021,22.77,-102.58,1677911
Veracruz,334,Mexico,66264,10213,56051,07/05/2021,19.17,-96.13,1395545
Guanajuato,335,Mexico,133174,11116,122058,07/05/2021,21.02,-101.26,6280645
Morelos,336,Mexico,34514,3582,30932,07/05/2021,18.68,-99.1,2065014
Mexico,337,Mexico,260922,37449,223473,07/05/2021,19.5,-99.72,8490806
Nuevo Leon,338,Mexico,127976,9768,118208,07/05/2021,25.59,-100,1306145
Yucatan,339,Mexico,47803,4246,43557,07/05/2021,20.71,-89.09,8588469
Nayarit,340,Mexico,12877,1880,10997,07/05/2021,21.75,-104.85,1306145
San Luis Potosi,341,Mexico,65789,5449,60340,07/05/2021,22.16,-100.99,1761389
Baja California,342,Mexico,50920,8739,42181,07/05/2021,30.84,-115.28,3690160
Oaxaca,343,Mexico,48917,3977,44940,07/05/2021,17.07,-96.73,4165619
Baja California Sur,344,Mexico,40754,1574,39180,07/05/2021,26.04,-111.67,821059
Colima,345,Mexico,12445,1222,11223,07/05/2021,19.12,-104.01,797245
Quintana Roo,346,Mexico,33858,3049,30809,07/05/2021,19.18,-88.48,1761389
Michoacan,347,Mexico,49420,5995,43425,07/05/2021,19.57,-101.71,8490806
Queretaro,348,Mexico,69949,4471,65478,07/05/2021,20.59,-100.39,6664764
Ciudad de Mexico,349,Mexico,690995,34755,656240,07/05/2021,19.43,-99.13,3836506
Sinaloa,350,Mexico,43464,6444,37020,07/05/2021,25.17,-107.48,3181609
Jalisco,351,Mexico,89353,12712,76641,07/05/2021,20.66,-103.35,8490806
Campeche,352,Mexico,12090,1318,10772,07/05/2021,19.83,-90.53,1017011
Mexico,353,Mexico,261133,37453,223680,07/06/2021,19.5,-99.72,8490806
Chiapas,354,Mexico,12492,1680,10812,07/06/2021,16.76,-93.13,5812375
Puebla,355,Mexico,86563,12317,74246,07/06/2021,19.04,-98.21,6664764
Tabasco,356,Mexico,78021,4298,73723,07/06/2021,17.84,-92.62,2599658
Guerrero,357,Mexico,42109,4564,37545,07/06/2021,17.44,-99.55,3668973
Zacatecas,358,Mexico,31155,2836,28319,07/06/2021,22.77,-102.58,1677911
Tamaulipas,359,Mexico,66457,5312,61145,07/06/2021,24.27,-98.84,3679623
Baja California Sur,360,Mexico,40904,1574,39330,07/06/2021,26.04,-111.67,821059
Ciudad de Mexico,361,Mexico,691748,34761,656987,07/06/2021,19.43,-99.13,3836506
Durango,362,Mexico,34848,2501,32347,07/06/2021,24.56,-104.66,1884622
Coahuila,363,Mexico,69758,6426,63332,07/06/2021,27.06,-101.71,9003827
Hidalgo,364,Mexico,39767,6288,33479,07/06/2021,20.09,-98.76,3121355
Michoacan,365,Mexico,49431,5995,43436,07/06/2021,19.57,-101.71,8490806
San Luis Potosi,366,Mexico,65810,5449,60361,07/06/2021,22.16,-100.99,1761389
Tlaxcala,367,Mexico,20219,2569,17650,07/06/2021,19.31,-98.24,1395545
Quintana Roo,368,Mexico,34115,3053,31062,07/06/2021,19.18,-88.48,1761389
Jalisco,369,Mexico,89402,12712,76690,07/06/2021,20.66,-103.35,8490806
Baja California,370,Mexico,50941,8739,42202,07/06/2021,30.84,-115.28,3690160
Oaxaca,371,Mexico,48937,3977,44960,07/06/2021,17.07,-96.73,4165619
Campeche,372,Mexico,12132,1319,10813,07/06/2021,19.83,-90.53,1017011
Sonora,373,Mexico,80439,6803,73636,07/06/2021,29.3,-110.33,3111119
Sinaloa,374,Mexico,43539,6444,37095,07/06/2021,25.17,-107.48,3181609
Colima,375,Mexico,12450,1222,11228,07/06/2021,19.12,-104.01,797245
Queretaro,376,Mexico,69973,4471,65502,07/06/2021,20.59,-100.39,6664764
Guanajuato,377,Mexico,133176,11116,122060,07/06/2021,21.02,-101.26,6280645
Yucatan,378,Mexico,47896,4255,43641,07/06/2021,20.71,-89.09,8588469
Chihuahua,379,Mexico,57931,7570,50361,07/06/2021,28.63,-106.07,3836506
Veracruz,380,Mexico,66394,10216,56178,07/06/2021,19.17,-96.13,1395545
Nuevo Leon,381,Mexico,128075,9770,118305,07/06/2021,25.59,-100,1306145
Morelos,382,Mexico,34517,3582,30935,07/06/2021,18.68,-99.1,2065014
Nayarit,383,Mexico,12918,1880,11038,07/06/2021,21.75,-104.85,1306145
Aguascalientes,384,Mexico,26818,2470,24348,07/06/2021,21.89,-102.29,1453452
Hidalgo,385,Mexico,39782,6291,33491,07/07/2021,20.09,-98.76,3121355
Tamaulipas,386,Mexico,66570,5318,61252,07/07/2021,24.27,-98.84,3679623
Yucatan,387,Mexico,47962,4265,43697,07/07/2021,20.71,-89.09,8588469
Tlaxcala,388,Mexico,20222,2569,17653,07/07/2021,19.31,-98.24,1395545
Guanajuato,389,Mexico,133181,11116,122065,07/07/2021,21.02,-101.26,6280645
Jalisco,390,Mexico,89442,12713,76729,07/07/2021,20.66,-103.35,8490806
Mexico,391,Mexico,261292,37462,223830,07/07/2021,19.5,-99.72,8490806
Puebla,392,Mexico,86584,12318,74266,07/07/2021,19.04,-98.21,6664764
Zacatecas,393,Mexico,31159,2836,28323,07/07/2021,22.77,-102.58,1677911
Sonora,394,Mexico,80512,6803,73709,07/07/2021,29.3,-110.33,3111119
Oaxaca,395,Mexico,48962,3978,44984,07/07/2021,17.07,-96.73,4165619
Campeche,396,Mexico,12165,1325,10840,07/07/2021,19.83,-90.53,1017011
Nuevo Leon,397,Mexico,128139,9770,118369,07/07/2021,25.59,-100,1306145
Aguascalientes,398,Mexico,26818,2470,24348,07/07/2021,21.89,-102.29,1453452
Quintana Roo,399,Mexico,34201,3058,31143,07/07/2021,19.18,-88.48,1761389
Tabasco,400,Mexico,78228,4300,73928,07/07/2021,17.84,-92.62,2599658
Colima,401,Mexico,12455,1222,11233,07/07/2021,19.12,-104.01,797245
Baja California,402,Mexico,50948,8740,42208,07/07/2021,30.84,-115.28,3690160
San Luis Potosi,403,Mexico,65814,5449,60365,07/07/2021,22.16,-100.99,1761389
Queretaro,404,Mexico,69984,4471,65513,07/07/2021,20.59,-100.39,6664764
Chiapas,405,Mexico,12527,1681,10846,07/07/2021,16.76,-93.13,5812375
Baja California Sur,406,Mexico,40985,1574,39411,07/07/2021,26.04,-111.67,821059
Ciudad de Mexico,407,Mexico,692281,34776,657505,07/07/2021,19.43,-99.13,3836506
Coahuila,408,Mexico,69767,6426,63341,07/07/2021,27.06,-101.71,9003827
Nayarit,409,Mexico,12926,1882,11044,07/07/2021,21.75,-104.85,1306145
Michoacan,410,Mexico,49441,5995,43446,07/07/2021,19.57,-101.71,8490806
Durango,411,Mexico,34855,2501,32354,07/07/2021,24.56,-104.66,1884622
Chihuahua,412,Mexico,57937,7570,50367,07/07/2021,28.63,-106.07,3836506
Sinaloa,413,Mexico,43593,6445,37148,07/07/2021,25.17,-107.48,3181609
Morelos,414,Mexico,34522,3584,30938,07/07/2021,18.68,-99.1,2065014
Guerrero,415,Mexico,42123,4564,37559,07/07/2021,17.44,-99.55,3668973
Veracruz,416,Mexico,66496,10217,56279,07/07/2021,19.17,-96.13,1395545
Queretaro,417,Mexico,70086,4475,65611,07/08/2021,20.59,-100.39,6664764
Tlaxcala,418,Mexico,20225,2571,17654,07/08/2021,19.31,-98.24,1395545
Mexico,419,Mexico,261935,37483,224452,07/08/2021,19.5,-99.72,8490806
Campeche,420,Mexico,12255,1327,10928,07/08/2021,19.83,-90.53,1017011
Colima,421,Mexico,12485,1223,11262,07/08/2021,19.12,-104.01,797245
Chiapas,422,Mexico,12571,1685,10886,07/08/2021,16.76,-93.13,5812375
Chihuahua,423,Mexico,57991,7573,50418,07/08/2021,28.63,-106.07,3836506
Nayarit,424,Mexico,13004,1883,11121,07/08/2021,21.75,-104.85,1306145
Guanajuato,425,Mexico,133252,11114,122138,07/08/2021,21.02,-101.26,6280645
Nuevo Leon,426,Mexico,128451,9771,118680,07/08/2021,25.59,-100,1306145
Baja California,427,Mexico,51009,8746,42263,07/08/2021,30.84,-115.28,3690160
Michoacan,428,Mexico,49496,6001,43495,07/08/2021,19.57,-101.71,8490806
Durango,429,Mexico,34901,2504,32397,07/08/2021,24.56,-104.66,1884622
Quintana Roo,430,Mexico,34517,3073,31444,07/08/2021,19.18,-88.48,1761389
Aguascalientes,431,Mexico,26834,2469,24365,07/08/2021,21.89,-102.29,1453452
Tabasco,432,Mexico,78455,4304,74151,07/08/2021,17.84,-92.62,2599658
Yucatan,433,Mexico,48249,4279,43970,07/08/2021,20.71,-89.09,8588469
Tamaulipas,434,Mexico,66907,5323,61584,07/08/2021,24.27,-98.84,3679623
Jalisco,435,Mexico,89680,12724,76956,07/08/2021,20.66,-103.35,8490806
Coahuila,436,Mexico,69846,6469,63377,07/08/2021,27.06,-101.71,9003827
Guerrero,437,Mexico,42252,4568,37684,07/08/2021,17.44,-99.55,3668973
Veracruz,438,Mexico,66836,10246,56590,07/08/2021,19.17,-96.13,1395545
Sonora,439,Mexico,80740,6815,73925,07/08/2021,29.3,-110.33,3111119
Sinaloa,440,Mexico,44045,6463,37582,07/08/2021,25.17,-107.48,3181609
Zacatecas,441,Mexico,31181,2838,28343,07/08/2021,22.77,-102.58,1677911
Puebla,442,Mexico,86634,12325,74309,07/08/2021,19.04,-98.21,6664764
Ciudad de Mexico,443,Mexico,695158,34803,660355,07/08/2021,19.43,-99.13,3836506
Oaxaca,444,Mexico,49136,3981,45155,07/08/2021,17.07,-96.73,4165619
Morelos,445,Mexico,34555,3593,30962,07/08/2021,18.68,-99.1,2065014
Baja California Sur,446,Mexico,41431,1584,39847,07/08/2021,26.04,-111.67,821059
Hidalgo,447,Mexico,39858,6294,33564,07/08/2021,20.09,-98.76,3121355
San Luis Potosi,448,Mexico,65887,5451,60436,07/08/2021,22.16,-100.99,1761389
Tlaxcala,449,Mexico,20244,2586,17658,07/09/2021,19.31,-98.24,1395545
Michoacan,450,Mexico,49558,6002,43556,07/09/2021,19.57,-101.71,8490806
Baja California,451,Mexico,51079,8754,42325,07/09/2021,30.84,-115.28,3690160
Colima,452,Mexico,12518,1224,11294,07/09/2021,19.12,-104.01,797245
Tabasco,453,Mexico,78754,4313,74441,07/09/2021,17.84,-92.62,2599658
Yucatan,454,Mexico,48559,4291,44268,07/09/2021,20.71,-89.09,8588469
Sonora,455,Mexico,80986,6819,74167,07/09/2021,29.3,-110.33,3111119
Coahuila,456,Mexico,69893,6473,63420,07/09/2021,27.06,-101.71,9003827
Hidalgo,457,Mexico,39928,6297,33631,07/09/2021,20.09,-98.76,3121355
Baja California Sur,458,Mexico,41868,1604,40264,07/09/2021,26.04,-111.67,821059
Nuevo Leon,459,Mexico,128738,9778,118960,07/09/2021,25.59,-100,1306145
Aguascalientes,460,Mexico,26855,2471,24384,07/09/2021,21.89,-102.29,1453452
Zacatecas,461,Mexico,31210,2838,28372,07/09/2021,22.77,-102.58,1677911
Mexico,462,Mexico,262645,37490,225155,07/09/2021,19.5,-99.72,8490806
Veracruz,463,Mexico,67186,10262,56924,07/09/2021,19.17,-96.13,1395545
Puebla,464,Mexico,86722,12331,74391,07/09/2021,19.04,-98.21,6664764
Nayarit,465,Mexico,13096,1884,11212,07/09/2021,21.75,-104.85,1306145
Tamaulipas,466,Mexico,67178,5335,61843,07/09/2021,24.27,-98.84,3679623
Ciudad de Mexico,467,Mexico,698043,34828,663215,07/09/2021,19.43,-99.13,3836506
Guanajuato,468,Mexico,133365,11115,122250,07/09/2021,21.02,-101.26,6280645
Guerrero,469,Mexico,42435,4572,37863,07/09/2021,17.44,-99.55,3668973
Queretaro,470,Mexico,70202,4475,65727,07/09/2021,20.59,-100.39,6664764
Chihuahua,471,Mexico,58094,7577,50517,07/09/2021,28.63,-106.07,3836506
Jalisco,472,Mexico,89952,12735,77217,07/09/2021,20.66,-103.35,8490806
San Luis Potosi,473,Mexico,65970,5452,60518,07/09/2021,22.16,-100.99,1761389
Durango,474,Mexico,34930,2505,32425,07/09/2021,24.56,-104.66,1884622
Campeche,475,Mexico,12362,1342,11020,07/09/2021,19.83,-90.53,1017011
Morelos,476,Mexico,34765,3606,31159,07/09/2021,18.68,-99.1,2065014
Sinaloa,477,Mexico,44466,6475,37991,07/09/2021,25.17,-107.48,3181609
Oaxaca,478,Mexico,49316,3984,45332,07/09/2021,17.07,-96.73,4165619
Quintana Roo,479,Mexico,34848,3087,31761,07/09/2021,19.18,-88.48,1761389
Chiapas,480,Mexico,12604,1687,10917,07/09/2021,16.76,-93.13,5812375
Coahuila,481,Mexico,69954,6482,63472,07/10/2021,27.06,-101.71,9003827
Oaxaca,482,Mexico,49477,3987,45490,07/10/2021,17.07,-96.73,4165619
Campeche,483,Mexico,12481,1342,11139,07/10/2021,19.83,-90.53,1017011
Yucatan,484,Mexico,48896,4295,44601,07/10/2021,20.71,-89.09,8588469
Mexico,485,Mexico,263464,37511,225953,07/10/2021,19.5,-99.72,8490806
Morelos,486,Mexico,35124,3626,31498,07/10/2021,18.68,-99.1,2065014
Sinaloa,487,Mexico,44956,6487,38469,07/10/2021,25.17,-107.48,3181609
Sonora,488,Mexico,81268,6827,74441,07/10/2021,29.3,-110.33,3111119
Veracruz,489,Mexico,67612,10271,57341,07/10/2021,19.17,-96.13,1395545
Quintana Roo,490,Mexico,35180,3097,32083,07/10/2021,19.18,-88.48,1761389
Queretaro,491,Mexico,70308,4475,65833,07/10/2021,20.59,-100.39,6664764
Nayarit,492,Mexico,13192,1886,11306,07/10/2021,21.75,-104.85,1306145
Zacatecas,493,Mexico,31237,2840,28397,07/10/2021,22.77,-102.58,1677911
Nuevo Leon,494,Mexico,129056,9779,119277,07/10/2021,25.59,-100,1306145
Chihuahua,495,Mexico,58171,7582,50589,07/10/2021,28.63,-106.07,3836506
Puebla,496,Mexico,86820,12340,74480,07/10/2021,19.04,-98.21,6664764
Jalisco,497,Mexico,90228,12758,77470,07/10/2021,20.66,-103.35,8490806
Aguascalientes,498,Mexico,26869,2476,24393,07/10/2021,21.89,-102.29,1453452
Michoacan,499,Mexico,49615,6009,43606,07/10/2021,19.57,-101.71,8490806
Tamaulipas,500,Mexico,67448,5353,62095,07/10/2021,24.27,-98.84,3679623
San Luis Potosi,501,Mexico,66044,5457,60587,07/10/2021,22.16,-100.99,1761389
Guanajuato,502,Mexico,133467,11115,122352,07/10/2021,21.02,-101.26,6280645
Colima,503,Mexico,12554,1225,11329,07/10/2021,19.12,-104.01,797245
Baja California Sur,504,Mexico,42300,1643,40657,07/10/2021,26.04,-111.67,821059
Ciudad de Mexico,505,Mexico,701281,34858,666423,07/10/2021,19.43,-99.13,3836506
Baja California,506,Mexico,51146,8760,42386,07/10/2021,30.84,-115.28,3690160
Chiapas,507,Mexico,12652,1691,10961,07/10/2021,16.76,-93.13,5812375
Hidalgo,508,Mexico,40027,6298,33729,07/10/2021,20.09,-98.76,3121355
Tlaxcala,509,Mexico,20245,2586,17659,07/10/2021,19.31,-98.24,1395545
Guerrero,510,Mexico,42679,4578,38101,07/10/2021,17.44,-99.55,3668973
Durango,511,Mexico,34983,2505,32478,07/10/2021,24.56,-104.66,1884622
Tabasco,512,Mexico,79087,4319,74768,07/10/2021,17.84,-92.62,2599658
San Luis Potosi,513,Mexico,66122,5461,60661,07/11/2021,22.16,-100.99,1761389
Hidalgo,514,Mexico,40142,6302,33840,07/11/2021,20.09,-98.76,3121355
Colima,515,Mexico,12602,1225,11377,07/11/2021,19.12,-104.01,797245
Queretaro,516,Mexico,70422,4480,65942,07/11/2021,20.59,-100.39,6664764
Campeche,517,Mexico,12594,1352,11242,07/11/2021,19.83,-90.53,1017011
Nayarit,518,Mexico,13285,1887,11398,07/11/2021,21.75,-104.85,1306145
Tlaxcala,519,Mexico,20229,2593,17636,07/11/2021,19.31,-98.24,1395545
Oaxaca,520,Mexico,49620,3988,45632,07/11/2021,17.07,-96.73,4165619
Veracruz,521,Mexico,68052,10283,57769,07/11/2021,19.17,-96.13,1395545
Michoacan,522,Mexico,49671,6013,43658,07/11/2021,19.57,-101.71,8490806
Baja California Sur,523,Mexico,42697,1671,41026,07/11/2021,26.04,-111.67,821059
Aguascalientes,524,Mexico,26886,2476,24410,07/11/2021,21.89,-102.29,1453452
Morelos,525,Mexico,35333,3627,31706,07/11/2021,18.68,-99.1,2065014
Guanajuato,526,Mexico,133589,11118,122471,07/11/2021,21.02,-101.26,6280645
Zacatecas,527,Mexico,31266,2841,28425,07/11/2021,22.77,-102.58,1677911
Guerrero,528,Mexico,42920,4581,38339,07/11/2021,17.44,-99.55,3668973
Baja California,529,Mexico,51223,8764,42459,07/11/2021,30.84,-115.28,3690160
Coahuila,530,Mexico,70017,6482,63535,07/11/2021,27.06,-101.71,9003827
Puebla,531,Mexico,86888,12344,74544,07/11/2021,19.04,-98.21,6664764
Yucatan,532,Mexico,49229,4321,44908,07/11/2021,20.71,-89.09,8588469
Quintana Roo,533,Mexico,35594,3102,32492,07/11/2021,19.18,-88.48,1761389
Durango,534,Mexico,35014,2507,32507,07/11/2021,24.56,-104.66,1884622
Chiapas,535,Mexico,12678,1692,10986,07/11/2021,16.76,-93.13,5812375
Sonora,536,Mexico,81480,6832,74648,07/11/2021,29.3,-110.33,3111119
Tabasco,537,Mexico,79428,4325,75103,07/11/2021,17.84,-92.62,2599658
Sinaloa,538,Mexico,45386,6506,38880,07/11/2021,25.17,-107.48,3181609
Jalisco,539,Mexico,90604,12763,77841,07/11/2021,20.66,-103.35,8490806
Chihuahua,540,Mexico,58249,7583,50666,07/11/2021,28.63,-106.07,3836506
Ciudad de Mexico,541,Mexico,704488,34886,669602,07/11/2021,19.43,-99.13,3836506
Nuevo Leon,542,Mexico,129406,9781,119625,07/11/2021,25.59,-100,1306145
Mexico,543,Mexico,264333,37532,226801,07/11/2021,19.5,-99.72,8490806
Tamaulipas,544,Mexico,67693,5357,62336,07/11/2021,24.27,-98.84,3679623
Chiapas,545,Mexico,12711,1692,11019,07/12/2021,16.76,-93.13,5812375
Guerrero,546,Mexico,43181,4584,38597,07/12/2021,17.44,-99.55,3668973
Baja California Sur,547,Mexico,43113,1701,41412,07/12/2021,26.04,-111.67,821059
Queretaro,548,Mexico,70538,4488,66050,07/12/2021,20.59,-100.39,6664764
Hidalgo,549,Mexico,40258,6304,33954,07/12/2021,20.09,-98.76,3121355
Colima,550,Mexico,12645,1225,11420,07/12/2021,19.12,-104.01,797245
Puebla,551,Mexico,87042,12345,74697,07/12/2021,19.04,-98.21,6664764
Morelos,552,Mexico,35389,3626,31763,07/12/2021,18.68,-99.1,2065014
Guanajuato,553,Mexico,133710,11123,122587,07/12/2021,21.02,-101.26,6280645
Aguascalientes,554,Mexico,26901,2476,24425,07/12/2021,21.89,-102.29,1453452
Chihuahua,555,Mexico,58341,7587,50754,07/12/2021,28.63,-106.07,3836506
Baja California,556,Mexico,51273,8766,42507,07/12/2021,30.84,-115.28,3690160
Veracruz,557,Mexico,68575,10298,58277,07/12/2021,19.17,-96.13,1395545
Ciudad de Mexico,558,Mexico,707845,34911,672934,07/12/2021,19.43,-99.13,3836506
Durango,559,Mexico,35050,2509,32541,07/12/2021,24.56,-104.66,1884622
Mexico,560,Mexico,265142,37549,227593,07/12/2021,19.5,-99.72,8490806
Tabasco,561,Mexico,79772,4327,75445,07/12/2021,17.84,-92.62,2599658
Jalisco,562,Mexico,90994,12773,78221,07/12/2021,20.66,-103.35,8490806
Coahuila,563,Mexico,70086,6486,63600,07/12/2021,27.06,-101.71,9003827
Nuevo Leon,564,Mexico,129760,9809,119951,07/12/2021,25.59,-100,1306145
Michoacan,565,Mexico,49731,6018,43713,07/12/2021,19.57,-101.71,8490806
Sonora,566,Mexico,81772,6849,74923,07/12/2021,29.3,-110.33,3111119
Sinaloa,567,Mexico,45885,6526,39359,07/12/2021,25.17,-107.48,3181609
Quintana Roo,568,Mexico,35916,3108,32808,07/12/2021,19.18,-88.48,1761389
San Luis Potosi,569,Mexico,66200,5462,60738,07/12/2021,22.16,-100.99,1761389
Oaxaca,570,Mexico,49769,3990,45779,07/12/2021,17.07,-96.73,4165619
Campeche,571,Mexico,12706,1358,11348,07/12/2021,19.83,-90.53,1017011
Yucatan,572,Mexico,49540,4332,45208,07/12/2021,20.71,-89.09,8588469
Zacatecas,573,Mexico,31300,2843,28457,07/12/2021,22.77,-102.58,1677911
Tlaxcala,574,Mexico,20253,2594,17659,07/12/2021,19.31,-98.24,1395545
Nayarit,575,Mexico,13402,1887,11515,07/12/2021,21.75,-104.85,1306145
Tamaulipas,576,Mexico,67921,5361,62560,07/12/2021,24.27,-98.84,3679623
Sinaloa,1185,Mexico,56867,6994,49873,08/01/2021,25.17,-107.48,3181609
Tabasco,1186,Mexico,86776,4431,82345,08/01/2021,17.84,-92.62,2599658
Colima,1187,Mexico,15650,1257,14393,08/01/2021,19.12,-104.01,797245
Chihuahua,1188,Mexico,60164,7652,52512,08/01/2021,28.63,-106.07,3836506
Guerrero,1189,Mexico,50980,4799,46181,08/01/2021,17.44,-99.55,3668973
Mexico,1190,Mexico,290172,38236,251936,08/01/2021,19.5,-99.72,8490806
Zacatecas,1191,Mexico,33069,2923,30146,08/01/2021,22.77,-102.58,1677911
Sonora,1192,Mexico,88205,7007,81198,08/01/2021,29.3,-110.33,3111119
Baja California,1193,Mexico,52600,8901,43699,08/01/2021,30.84,-115.28,3690160
Veracruz,1194,Mexico,79456,10663,68793,08/01/2021,19.17,-96.13,1395545
Morelos,1195,Mexico,36903,3655,33248,08/01/2021,18.68,-99.1,2065014
Tlaxcala,1196,Mexico,21122,2614,18508,08/01/2021,19.31,-98.24,1395545
Baja California Sur,1197,Mexico,48958,1979,46979,08/01/2021,26.04,-111.67,821059
Puebla,1198,Mexico,90747,12476,78271,08/01/2021,19.04,-98.21,6664764
Nuevo Leon,1199,Mexico,141774,10101,131673,08/01/2021,25.59,-100,1306145
Coahuila,1200,Mexico,72745,6539,66206,08/01/2021,27.06,-101.71,9003827
Tamaulipas,1201,Mexico,72609,5502,67107,08/01/2021,24.27,-98.84,3679623
Durango,1202,Mexico,37252,2539,34713,08/01/2021,24.56,-104.66,1884622
Queretaro,1203,Mexico,73939,4549,69390,08/01/2021,20.59,-100.39,6664764
Nayarit,1204,Mexico,18495,2003,16492,08/01/2021,21.75,-104.85,1306145
Guanajuato,1205,Mexico,138447,11167,127280,08/01/2021,21.02,-101.26,6280645
Campeche,1206,Mexico,14482,1448,13034,08/01/2021,19.83,-90.53,1017011
Quintana Roo,1207,Mexico,43247,3308,39939,08/01/2021,19.18,-88.48,1761389
Hidalgo,1208,Mexico,44090,6418,37672,08/01/2021,20.09,-98.76,3121355
Oaxaca,1209,Mexico,54881,4145,50736,08/01/2021,17.07,-96.73,4165619
Michoacan,1210,Mexico,53394,6167,47227,08/01/2021,19.57,-101.71,8490806
Aguascalientes,1211,Mexico,27828,2490,25338,08/01/2021,21.89,-102.29,1453452
Jalisco,1212,Mexico,104946,13084,91862,08/01/2021,20.66,-103.35,8490806
Chiapas,1213,Mexico,14193,1750,12443,08/01/2021,16.76,-93.13,5812375
San Luis Potosi,1214,Mexico,70591,5507,65084,08/01/2021,22.16,-100.99,1761389
Yucatan,1215,Mexico,54150,4526,49624,08/01/2021,20.71,-89.09,8588469
Ciudad de Mexico,1216,Mexico,780711,35626,745085,08/01/2021,19.43,-99.13,3836506
Coahuila,1217,Mexico,73119,6542,66577,08/02/2021,27.06,-101.71,9003827
Tamaulipas,1218,Mexico,73193,5516,67677,08/02/2021,24.27,-98.84,3679623
Aguascalientes,1219,Mexico,27921,2494,25427,08/02/2021,21.89,-102.29,1453452
Sinaloa,1220,Mexico,57738,7026,50712,08/02/2021,25.17,-107.48,3181609
Colima,1221,Mexico,16098,1264,14834,08/02/2021,19.12,-104.01,797245
Baja California,1222,Mexico,52768,8910,43858,08/02/2021,30.84,-115.28,3690160
Quintana Roo,1223,Mexico,43974,3327,40647,08/02/2021,19.18,-88.48,1761389
Jalisco,1224,Mexico,106645,13129,93516,08/02/2021,20.66,-103.35,8490806
Sonora,1225,Mexico,88800,7035,81765,08/02/2021,29.3,-110.33,3111119
Nayarit,1226,Mexico,19212,2022,17190,08/02/2021,21.75,-104.85,1306145
Veracruz,1227,Mexico,80461,10696,69765,08/02/2021,19.17,-96.13,1395545
Puebla,1228,Mexico,91287,12490,78797,08/02/2021,19.04,-98.21,6664764
Guerrero,1229,Mexico,52029,4820,47209,08/02/2021,17.44,-99.55,3668973
Campeche,1230,Mexico,14742,1457,13285,08/02/2021,19.83,-90.53,1017011
Ciudad de Mexico,1231,Mexico,787339,35685,751654,08/02/2021,19.43,-99.13,3836506
Tlaxcala,1232,Mexico,21284,2615,18669,08/02/2021,19.31,-98.24,1395545
Durango,1233,Mexico,37609,2539,35070,08/02/2021,24.56,-104.66,1884622
Zacatecas,1234,Mexico,33405,2926,30479,08/02/2021,22.77,-102.58,1677911
Morelos,1235,Mexico,37105,3662,33443,08/02/2021,18.68,-99.1,2065014
Queretaro,1236,Mexico,74019,4581,69438,08/02/2021,20.59,-100.39,6664764
Guanajuato,1237,Mexico,138894,11173,127721,08/02/2021,21.02,-101.26,6280645
Tabasco,1238,Mexico,87667,4439,83228,08/02/2021,17.84,-92.62,2599658
Michoacan,1239,Mexico,53927,6176,47751,08/02/2021,19.57,-101.71,8490806
Mexico,1240,Mexico,292617,38297,254320,08/02/2021,19.5,-99.72,8490806
Baja California Sur,1241,Mexico,49335,1996,47339,08/02/2021,26.04,-111.67,821059
Hidalgo,1242,Mexico,44552,6432,38120,08/02/2021,20.09,-98.76,3121355
San Luis Potosi,1243,Mexico,71280,5518,65762,08/02/2021,22.16,-100.99,1761389
Nuevo Leon,1244,Mexico,143203,10152,133051,08/02/2021,25.59,-100,1306145
Yucatan,1245,Mexico,54511,4545,49966,08/02/2021,20.71,-89.09,8588469
Oaxaca,1246,Mexico,55367,4157,51210,08/02/2021,17.07,-96.73,4165619
Chihuahua,1247,Mexico,60321,7656,52665,08/02/2021,28.63,-106.07,3836506
Chiapas,1248,Mexico,14570,1757,12813,08/02/2021,16.76,-93.13,5812375
Hidalgo,1249,Mexico,44552,6432,38120,08/03/2021,20.09,-98.76,3121355
Ciudad de Mexico,1250,Mexico,787339,35685,751654,08/03/2021,19.43,-99.13,3836506
Tamaulipas,1251,Mexico,73193,5516,67677,08/03/2021,24.27,-98.84,3679623
Baja California,1252,Mexico,52768,8910,43858,08/03/2021,30.84,-115.28,3690160
Tabasco,1253,Mexico,87667,4439,83228,08/03/2021,17.84,-92.62,2599658
Jalisco,1254,Mexico,106645,13129,93516,08/03/2021,20.66,-103.35,8490806
Morelos,1255,Mexico,37105,3662,33443,08/03/2021,18.68,-99.1,2065014
Campeche,1256,Mexico,14742,1457,13285,08/03/2021,19.83,-90.53,1017011
Durango,1257,Mexico,37609,2539,35070,08/03/2021,24.56,-104.66,1884622
Queretaro,1258,Mexico,74019,4581,69438,08/03/2021,20.59,-100.39,6664764
Veracruz,1259,Mexico,80461,10696,69765,08/03/2021,19.17,-96.13,1395545
Sinaloa,1260,Mexico,57738,7026,50712,08/03/2021,25.17,-107.48,3181609
Mexico,1261,Mexico,292617,38297,254320,08/03/2021,19.5,-99.72,8490806
Guerrero,1262,Mexico,52029,4820,47209,08/03/2021,17.44,-99.55,3668973
Nayarit,1263,Mexico,19212,2022,17190,08/03/2021,21.75,-104.85,1306145
Puebla,1264,Mexico,91287,12490,78797,08/03/2021,19.04,-98.21,6664764
Chihuahua,1265,Mexico,60321,7656,52665,08/03/2021,28.63,-106.07,3836506
Yucatan,1266,Mexico,54511,4545,49966,08/03/2021,20.71,-89.09,8588469
Chiapas,1267,Mexico,14570,1757,12813,08/03/2021,16.76,-93.13,5812375
Quintana Roo,1268,Mexico,43974,3327,40647,08/03/2021,19.18,-88.48,1761389
Sonora,1269,Mexico,88800,7035,81765,08/03/2021,29.3,-110.33,3111119
San Luis Potosi,1270,Mexico,71280,5518,65762,08/03/2021,22.16,-100.99,1761389
Coahuila,1271,Mexico,73119,6542,66577,08/03/2021,27.06,-101.71,9003827
Oaxaca,1272,Mexico,55367,4157,51210,08/03/2021,17.07,-96.73,4165619
Aguascalientes,1273,Mexico,27921,2494,25427,08/03/2021,21.89,-102.29,1453452
Nuevo Leon,1274,Mexico,143203,10152,133051,08/03/2021,25.59,-100,1306145
Tlaxcala,1275,Mexico,21284,2615,18669,08/03/2021,19.31,-98.24,1395545
Colima,1276,Mexico,16098,1264,14834,08/03/2021,19.12,-104.01,797245
Michoacan,1277,Mexico,53927,6176,47751,08/03/2021,19.57,-101.71,8490806
Zacatecas,1278,Mexico,33405,2926,30479,08/03/2021,22.77,-102.58,1677911
Baja California Sur,1279,Mexico,49335,1996,47339,08/03/2021,26.04,-111.67,821059
Guanajuato,1280,Mexico,138894,11173,127721,08/03/2021,21.02,-101.26,6280645
Tlaxcala,1281,Mexico,21322,2616,18706,08/04/2021,19.31,-98.24,1395545
Zacatecas,1282,Mexico,33454,2926,30528,08/04/2021,22.77,-102.58,1677911
Baja California Sur,1283,Mexico,49387,1996,47391,08/04/2021,26.04,-111.67,821059
Chihuahua,1284,Mexico,60342,7658,52684,08/04/2021,28.63,-106.07,3836506
Aguascalientes,1285,Mexico,27946,2494,25452,08/04/2021,21.89,-102.29,1453452
Baja California,1286,Mexico,52784,8916,43868,08/04/2021,30.84,-115.28,3690160
Nayarit,1287,Mexico,19319,2023,17296,08/04/2021,21.75,-104.85,1306145
Yucatan,1288,Mexico,54551,4554,49997,08/04/2021,20.71,-89.09,8588469
Queretaro,1289,Mexico,74013,4581,69432,08/04/2021,20.59,-100.39,6664764
Sinaloa,1290,Mexico,57934,7026,50908,08/04/2021,25.17,-107.48,3181609
Morelos,1291,Mexico,37132,3665,33467,08/04/2021,18.68,-99.1,2065014
San Luis Potosi,1292,Mexico,71431,5522,65909,08/04/2021,22.16,-100.99,1761389
Nuevo Leon,1293,Mexico,143529,10174,133355,08/04/2021,25.59,-100,1306145
Quintana Roo,1294,Mexico,44171,3336,40835,08/04/2021,19.18,-88.48,1761389
Hidalgo,1295,Mexico,44669,6438,38231,08/04/2021,20.09,-98.76,3121355
Jalisco,1296,Mexico,106911,13135,93776,08/04/2021,20.66,-103.35,8490806
Chiapas,1297,Mexico,14780,1768,13012,08/04/2021,16.76,-93.13,5812375
Tabasco,1298,Mexico,88127,4443,83684,08/04/2021,17.84,-92.62,2599658
Veracruz,1299,Mexico,81047,10707,70340,08/04/2021,19.17,-96.13,1395545
Coahuila,1300,Mexico,73209,6545,66664,08/04/2021,27.06,-101.71,9003827
Guanajuato,1301,Mexico,138946,11174,127772,08/04/2021,21.02,-101.26,6280645
Ciudad de Mexico,1302,Mexico,788997,35745,753252,08/04/2021,19.43,-99.13,3836506
Michoacan,1303,Mexico,54036,6188,47848,08/04/2021,19.57,-101.71,8490806
Puebla,1304,Mexico,91430,12492,78938,08/04/2021,19.04,-98.21,6664764
Guerrero,1305,Mexico,52303,4823,47480,08/04/2021,17.44,-99.55,3668973
Durango,1306,Mexico,37629,2539,35090,08/04/2021,24.56,-104.66,1884622
Campeche,1307,Mexico,14792,1460,13332,08/04/2021,19.83,-90.53,1017011
Mexico,1308,Mexico,293257,38344,254913,08/04/2021,19.5,-99.72,8490806
Oaxaca,1309,Mexico,55456,4167,51289,08/04/2021,17.07,-96.73,4165619
Tamaulipas,1310,Mexico,73374,5519,67855,08/04/2021,24.27,-98.84,3679623
Colima,1311,Mexico,16208,1265,14943,08/04/2021,19.12,-104.01,797245
Sonora,1312,Mexico,89012,7040,81972,08/04/2021,29.3,-110.33,3111119
Tabasco,1313,Mexico,88736,4454,84282,08/05/2021,17.84,-92.62,2599658
Jalisco,1314,Mexico,107973,13179,94794,08/05/2021,20.66,-103.35,8490806
Queretaro,1315,Mexico,74229,4587,69642,08/05/2021,20.59,-100.39,6664764
Baja California,1316,Mexico,52895,8923,43972,08/05/2021,30.84,-115.28,3690160
Nuevo Leon,1317,Mexico,144508,10203,134305,08/05/2021,25.59,-100,1306145
Tamaulipas,1318,Mexico,73656,5529,68127,08/05/2021,24.27,-98.84,3679623
Campeche,1319,Mexico,14930,1472,13458,08/05/2021,19.83,-90.53,1017011
Colima,1320,Mexico,16620,1272,15348,08/05/2021,19.12,-104.01,797245
Guanajuato,1321,Mexico,139494,11179,128315,08/05/2021,21.02,-101.26,6280645
Yucatan,1322,Mexico,54816,4564,50252,08/05/2021,20.71,-89.09,8588469
Quintana Roo,1323,Mexico,44559,3343,41216,08/05/2021,19.18,-88.48,1761389
Morelos,1324,Mexico,37316,3666,33650,08/05/2021,18.68,-99.1,2065014
Sonora,1325,Mexico,89572,7071,82501,08/05/2021,29.3,-110.33,3111119
Mexico,1326,Mexico,295320,38406,256914,08/05/2021,19.5,-99.72,8490806
San Luis Potosi,1327,Mexico,71930,5532,66398,08/05/2021,22.16,-100.99,1761389
Coahuila,1328,Mexico,73509,6552,66957,08/05/2021,27.06,-101.71,9003827
Hidalgo,1329,Mexico,44992,6447,38545,08/05/2021,20.09,-98.76,3121355
Zacatecas,1330,Mexico,33598,2938,30660,08/05/2021,22.77,-102.58,1677911
Oaxaca,1331,Mexico,55958,4175,51783,08/05/2021,17.07,-96.73,4165619
Aguascalientes,1332,Mexico,28044,2496,25548,08/05/2021,21.89,-102.29,1453452
Guerrero,1333,Mexico,53073,4864,48209,08/05/2021,17.44,-99.55,3668973
Puebla,1334,Mexico,91813,12508,79305,08/05/2021,19.04,-98.21,6664764
Veracruz,1335,Mexico,81775,10805,70970,08/05/2021,19.17,-96.13,1395545
Nayarit,1336,Mexico,19751,2043,17708,08/05/2021,21.75,-104.85,1306145
Baja California Sur,1337,Mexico,49699,2004,47695,08/05/2021,26.04,-111.67,821059
Chiapas,1338,Mexico,14990,1782,13208,08/05/2021,16.76,-93.13,5812375
Tlaxcala,1339,Mexico,21426,2618,18808,08/05/2021,19.31,-98.24,1395545
Ciudad de Mexico,1340,Mexico,793882,35813,758069,08/05/2021,19.43,-99.13,3836506
Michoacan,1341,Mexico,54410,6211,48199,08/05/2021,19.57,-101.71,8490806
Sinaloa,1342,Mexico,58515,7092,51423,08/05/2021,25.17,-107.48,3181609
Chihuahua,1343,Mexico,60483,7663,52820,08/05/2021,28.63,-106.07,3836506
Durango,1344,Mexico,37937,2545,35392,08/05/2021,24.56,-104.66,1884622
Jalisco,1345,Mexico,109128,13246,95882,08/06/2021,20.66,-103.35,8490806
Queretaro,1346,Mexico,74460,4592,69868,08/06/2021,20.59,-100.39,6664764
Michoacan,1347,Mexico,54823,6233,48590,08/06/2021,19.57,-101.71,8490806
Chihuahua,1348,Mexico,60595,7667,52928,08/06/2021,28.63,-106.07,3836506
Sonora,1349,Mexico,90022,7085,82937,08/06/2021,29.3,-110.33,3111119
Sinaloa,1350,Mexico,59046,7117,51929,08/06/2021,25.17,-107.48,3181609
Mexico,1351,Mexico,297540,38509,259031,08/06/2021,19.5,-99.72,8490806
Durango,1352,Mexico,38251,2560,35691,08/06/2021,24.56,-104.66,1884622
Quintana Roo,1353,Mexico,45039,3359,41680,08/06/2021,19.18,-88.48,1761389
Nayarit,1354,Mexico,20362,2063,18299,08/06/2021,21.75,-104.85,1306145
Oaxaca,1355,Mexico,56456,4185,52271,08/06/2021,17.07,-96.73,4165619
Nuevo Leon,1356,Mexico,145738,10218,135520,08/06/2021,25.59,-100,1306145
Guanajuato,1357,Mexico,140012,11186,128826,08/06/2021,21.02,-101.26,6280645
Morelos,1358,Mexico,37451,3673,33778,08/06/2021,18.68,-99.1,2065014
Zacatecas,1359,Mexico,33765,2944,30821,08/06/2021,22.77,-102.58,1677911
Hidalgo,1360,Mexico,45390,6464,38926,08/06/2021,20.09,-98.76,3121355
Aguascalientes,1361,Mexico,28189,2497,25692,08/06/2021,21.89,-102.29,1453452
Colima,1362,Mexico,17036,1278,15758,08/06/2021,19.12,-104.01,797245
Tlaxcala,1363,Mexico,21506,2619,18887,08/06/2021,19.31,-98.24,1395545
Coahuila,1364,Mexico,73804,6561,67243,08/06/2021,27.06,-101.71,9003827
Baja California Sur,1365,Mexico,50027,2013,48014,08/06/2021,26.04,-111.67,821059
Veracruz,1366,Mexico,82666,10851,71815,08/06/2021,19.17,-96.13,1395545
Baja California,1367,Mexico,53025,8927,44098,08/06/2021,30.84,-115.28,3690160
Campeche,1368,Mexico,15109,1484,13625,08/06/2021,19.83,-90.53,1017011
Tamaulipas,1369,Mexico,74044,5541,68503,08/06/2021,24.27,-98.84,3679623
San Luis Potosi,1370,Mexico,72498,5540,66958,08/06/2021,22.16,-100.99,1761389
Puebla,1371,Mexico,92228,12523,79705,08/06/2021,19.04,-98.21,6664764
Yucatan,1372,Mexico,55094,4603,50491,08/06/2021,20.71,-89.09,8588469
Ciudad de Mexico,1373,Mexico,799306,35874,763432,08/06/2021,19.43,-99.13,3836506
Guerrero,1374,Mexico,53919,4882,49037,08/06/2021,17.44,-99.55,3668973
Tabasco,1375,Mexico,89316,4460,84856,08/06/2021,17.84,-92.62,2599658
Chiapas,1376,Mexico,15249,1793,13456,08/06/2021,16.76,-93.13,5812375
Baja California Sur,1377,Mexico,50280,2030,48250,08/07/2021,26.04,-111.67,821059
Ciudad de Mexico,1378,Mexico,804298,35964,768334,08/07/2021,19.43,-99.13,3836506
Jalisco,1379,Mexico,110504,13301,97203,08/07/2021,20.66,-103.35,8490806
Sonora,1380,Mexico,90477,7104,83373,08/07/2021,29.3,-110.33,3111119
Nayarit,1381,Mexico,20990,2089,18901,08/07/2021,21.75,-104.85,1306145
Coahuila,1382,Mexico,74196,6574,67622,08/07/2021,27.06,-101.71,9003827
Veracruz,1383,Mexico,83523,10878,72645,08/07/2021,19.17,-96.13,1395545
San Luis Potosi,1384,Mexico,73208,5547,67661,08/07/2021,22.16,-100.99,1761389
Zacatecas,1385,Mexico,33979,2946,31033,08/07/2021,22.77,-102.58,1677911
Puebla,1386,Mexico,92803,12538,80265,08/07/2021,19.04,-98.21,6664764
Morelos,1387,Mexico,37708,3679,34029,08/07/2021,18.68,-99.1,2065014
Quintana Roo,1388,Mexico,45510,3372,42138,08/07/2021,19.18,-88.48,1761389
Sinaloa,1389,Mexico,59525,7140,52385,08/07/2021,25.17,-107.48,3181609
Chihuahua,1390,Mexico,60699,7673,53026,08/07/2021,28.63,-106.07,3836506
Tamaulipas,1391,Mexico,74529,5554,68975,08/07/2021,24.27,-98.84,3679623
Yucatan,1392,Mexico,55378,4619,50759,08/07/2021,20.71,-89.09,8588469
Campeche,1393,Mexico,15221,1484,13737,08/07/2021,19.83,-90.53,1017011
Michoacan,1394,Mexico,55253,6245,49008,08/07/2021,19.57,-101.71,8490806
Guanajuato,1395,Mexico,140597,11196,129401,08/07/2021,21.02,-101.26,6280645
Guerrero,1396,Mexico,54719,4922,49797,08/07/2021,17.44,-99.55,3668973
Mexico,1397,Mexico,299839,38612,261227,08/07/2021,19.5,-99.72,8490806
Oaxaca,1398,Mexico,56840,4203,52637,08/07/2021,17.07,-96.73,4165619
Tabasco,1399,Mexico,89990,4470,85520,08/07/2021,17.84,-92.62,2599658
Colima,1400,Mexico,17413,1285,16128,08/07/2021,19.12,-104.01,797245
Nuevo Leon,1401,Mexico,147299,10249,137050,08/07/2021,25.59,-100,1306145
Queretaro,1402,Mexico,74801,4599,70202,08/07/2021,20.59,-100.39,6664764
Hidalgo,1403,Mexico,45757,6475,39282,08/07/2021,20.09,-98.76,3121355
Aguascalientes,1404,Mexico,28361,2500,25861,08/07/2021,21.89,-102.29,1453452
Tlaxcala,1405,Mexico,21649,2621,19028,08/07/2021,19.31,-98.24,1395545
Baja California,1406,Mexico,53166,8929,44237,08/07/2021,30.84,-115.28,3690160
Durango,1407,Mexico,38581,2562,36019,08/07/2021,24.56,-104.66,1884622
Chiapas,1408,Mexico,15570,1805,13765,08/07/2021,16.76,-93.13,5812375
Nuevo Leon,1409,Mexico,148789,10267,138522,08/08/2021,25.59,-100,1306145
Nayarit,1410,Mexico,21562,2095,19467,08/08/2021,21.75,-104.85,1306145
Hidalgo,1411,Mexico,46146,6492,39654,08/08/2021,20.09,-98.76,3121355
Oaxaca,1412,Mexico,57330,4211,53119,08/08/2021,17.07,-96.73,4165619
Jalisco,1413,Mexico,111809,13356,98453,08/08/2021,20.66,-103.35,8490806
Yucatan,1414,Mexico,55638,4633,51005,08/08/2021,20.71,-89.09,8588469
Ciudad de Mexico,1415,Mexico,809616,36028,773588,08/08/2021,19.43,-99.13,3836506
Baja California Sur,1416,Mexico,50494,2046,48448,08/08/2021,26.04,-111.67,821059
Zacatecas,1417,Mexico,34222,2950,31272,08/08/2021,22.77,-102.58,1677911
Chiapas,1418,Mexico,15913,1817,14096,08/08/2021,16.76,-93.13,5812375
Guanajuato,1419,Mexico,141120,11202,129918,08/08/2021,21.02,-101.26,6280645
Tlaxcala,1420,Mexico,21767,2622,19145,08/08/2021,19.31,-98.24,1395545
Sinaloa,1421,Mexico,60057,7177,52880,08/08/2021,25.17,-107.48,3181609
Coahuila,1422,Mexico,74540,6579,67961,08/08/2021,27.06,-101.71,9003827
Baja California,1423,Mexico,53302,8931,44371,08/08/2021,30.84,-115.28,3690160
San Luis Potosi,1424,Mexico,73938,5555,68383,08/08/2021,22.16,-100.99,1761389
Sonora,1425,Mexico,90997,7116,83881,08/08/2021,29.3,-110.33,3111119
Aguascalientes,1426,Mexico,28502,2501,26001,08/08/2021,21.89,-102.29,1453452
Mexico,1427,Mexico,301988,38700,263288,08/08/2021,19.5,-99.72,8490806
Tamaulipas,1428,Mexico,74933,5566,69367,08/08/2021,24.27,-98.84,3679623
Michoacan,1429,Mexico,55732,6270,49462,08/08/2021,19.57,-101.71,8490806
Durango,1430,Mexico,38869,2562,36307,08/08/2021,24.56,-104.66,1884622
Queretaro,1431,Mexico,75236,4615,70621,08/08/2021,20.59,-100.39,6664764
Veracruz,1432,Mexico,84414,10926,73488,08/08/2021,19.17,-96.13,1395545
Chihuahua,1433,Mexico,60852,7676,53176,08/08/2021,28.63,-106.07,3836506
Puebla,1434,Mexico,93339,12559,80780,08/08/2021,19.04,-98.21,6664764
Morelos,1435,Mexico,37927,3680,34247,08/08/2021,18.68,-99.1,2065014
Quintana Roo,1436,Mexico,46000,3387,42613,08/08/2021,19.18,-88.48,1761389
Tabasco,1437,Mexico,90554,4477,86077,08/08/2021,17.84,-92.62,2599658
Campeche,1438,Mexico,15382,1492,13890,08/08/2021,19.83,-90.53,1017011
Guerrero,1439,Mexico,55428,4952,50476,08/08/2021,17.44,-99.55,3668973
Colima,1440,Mexico,17830,1293,16537,08/08/2021,19.12,-104.01,797245
Aguascalientes,1441,Mexico,28586,2504,26082,08/09/2021,21.89,-102.29,1453452
Zacatecas,1442,Mexico,34394,2954,31440,08/09/2021,22.77,-102.58,1677911
Yucatan,1443,Mexico,55905,4641,51264,08/09/2021,20.71,-89.09,8588469
Sinaloa,1444,Mexico,60583,7208,53375,08/09/2021,25.17,-107.48,3181609
Michoacan,1445,Mexico,56307,6288,50019,08/09/2021,19.57,-101.71,8490806
Coahuila,1446,Mexico,74859,6582,68277,08/09/2021,27.06,-101.71,9003827
Sonora,1447,Mexico,91389,7123,84266,08/09/2021,29.3,-110.33,3111119
Tamaulipas,1448,Mexico,75488,5571,69917,08/09/2021,24.27,-98.84,3679623
Oaxaca,1449,Mexico,57649,4225,53424,08/09/2021,17.07,-96.73,4165619
Tlaxcala,1450,Mexico,21936,2622,19314,08/09/2021,19.31,-98.24,1395545
Baja California,1451,Mexico,53448,8939,44509,08/09/2021,30.84,-115.28,3690160
Quintana Roo,1452,Mexico,46405,3402,43003,08/09/2021,19.18,-88.48,1761389
Morelos,1453,Mexico,38144,3684,34460,08/09/2021,18.68,-99.1,2065014
San Luis Potosi,1454,Mexico,74594,5562,69032,08/09/2021,22.16,-100.99,1761389
Nayarit,1455,Mexico,22067,2114,19953,08/09/2021,21.75,-104.85,1306145
Queretaro,1456,Mexico,75615,4620,70995,08/09/2021,20.59,-100.39,6664764
Hidalgo,1457,Mexico,46529,6509,40020,08/09/2021,20.09,-98.76,3121355
Jalisco,1458,Mexico,112855,13408,99447,08/09/2021,20.66,-103.35,8490806
Campeche,1459,Mexico,15578,1498,14080,08/09/2021,19.83,-90.53,1017011
Nuevo Leon,1460,Mexico,150353,10288,140065,08/09/2021,25.59,-100,1306145
Chiapas,1461,Mexico,16206,1821,14385,08/09/2021,16.76,-93.13,5812375
Tabasco,1462,Mexico,91193,4484,86709,08/09/2021,17.84,-92.62,2599658
Guanajuato,1463,Mexico,141582,11215,130367,08/09/2021,21.02,-101.26,6280645
Baja California Sur,1464,Mexico,50736,2059,48677,08/09/2021,26.04,-111.67,821059
Ciudad de Mexico,1465,Mexico,814132,36093,778039,08/09/2021,19.43,-99.13,3836506
Puebla,1466,Mexico,93889,12576,81313,08/09/2021,19.04,-98.21,6664764
Colima,1467,Mexico,18232,1298,16934,08/09/2021,19.12,-104.01,797245
Durango,1468,Mexico,39048,2573,36475,08/09/2021,24.56,-104.66,1884622
Guerrero,1469,Mexico,56244,4988,51256,08/09/2021,17.44,-99.55,3668973
Chihuahua,1470,Mexico,60980,7676,53304,08/09/2021,28.63,-106.07,3836506
Veracruz,1471,Mexico,85370,10956,74414,08/09/2021,19.17,-96.13,1395545
Mexico,1472,Mexico,303948,38767,265181,08/09/2021,19.5,-99.72,8490806
Queretaro,1473,Mexico,75756,4625,71131,08/10/2021,20.59,-100.39,6664764
Colima,1474,Mexico,18360,1300,17060,08/10/2021,19.12,-104.01,797245
Baja California Sur,1475,Mexico,50789,2059,48730,08/10/2021,26.04,-111.67,821059
Hidalgo,1476,Mexico,46694,6515,40179,08/10/2021,20.09,-98.76,3121355
Durango,1477,Mexico,39105,2573,36532,08/10/2021,24.56,-104.66,1884622
Baja California,1478,Mexico,53517,8940,44577,08/10/2021,30.84,-115.28,3690160
Morelos,1479,Mexico,38175,3685,34490,08/10/2021,18.68,-99.1,2065014
Guanajuato,1480,Mexico,141640,11215,130425,08/10/2021,21.02,-101.26,6280645
Guerrero,1481,Mexico,56493,4988,51505,08/10/2021,17.44,-99.55,3668973
Sinaloa,1482,Mexico,60851,7221,53630,08/10/2021,25.17,-107.48,3181609
Yucatan,1483,Mexico,55988,4643,51345,08/10/2021,20.71,-89.09,8588469
San Luis Potosi,1484,Mexico,74987,5562,69425,08/10/2021,22.16,-100.99,1761389
Aguascalientes,1485,Mexico,28593,2504,26089,08/10/2021,21.89,-102.29,1453452
Coahuila,1486,Mexico,74949,6586,68363,08/10/2021,27.06,-101.71,9003827
Chiapas,1487,Mexico,16302,1824,14478,08/10/2021,16.76,-93.13,5812375
Jalisco,1488,Mexico,113193,13427,99766,08/10/2021,20.66,-103.35,8490806
Nuevo Leon,1489,Mexico,150836,10295,140541,08/10/2021,25.59,-100,1306145
Tabasco,1490,Mexico,91749,4490,87259,08/10/2021,17.84,-92.62,2599658
Tamaulipas,1491,Mexico,75639,5572,70067,08/10/2021,24.27,-98.84,3679623
Ciudad de Mexico,1492,Mexico,815833,36116,779717,08/10/2021,19.43,-99.13,3836506
Chihuahua,1493,Mexico,60992,7676,53316,08/10/2021,28.63,-106.07,3836506
Mexico,1494,Mexico,304441,38791,265650,08/10/2021,19.5,-99.72,8490806
Puebla,1495,Mexico,94191,12584,81607,08/10/2021,19.04,-98.21,6664764
Veracruz,1496,Mexico,85690,10962,74728,08/10/2021,19.17,-96.13,1395545
Quintana Roo,1497,Mexico,46704,3411,43293,08/10/2021,19.18,-88.48,1761389
Campeche,1498,Mexico,15688,1503,14185,08/10/2021,19.83,-90.53,1017011
Tlaxcala,1499,Mexico,22019,2622,19397,08/10/2021,19.31,-98.24,1395545
Sonora,1500,Mexico,91700,7128,84572,08/10/2021,29.3,-110.33,3111119
Michoacan,1501,Mexico,56497,6297,50200,08/10/2021,19.57,-101.71,8490806
Oaxaca,1502,Mexico,57749,4228,53521,08/10/2021,17.07,-96.73,4165619
Zacatecas,1503,Mexico,34494,2954,31540,08/10/2021,22.77,-102.58,1677911
Nayarit,1504,Mexico,22203,2124,20079,08/10/2021,21.75,-104.85,1306145
Morelos,1505,Mexico,38200,3690,34510,08/11/2021,18.68,-99.1,2065014
Durango,1506,Mexico,39155,2573,36582,08/11/2021,24.56,-104.66,1884622
Sinaloa,1507,Mexico,60984,7233,53751,08/11/2021,25.17,-107.48,3181609
Jalisco,1508,Mexico,113373,13434,99939,08/11/2021,20.66,-103.35,8490806
Baja California,1509,Mexico,53536,8941,44595,08/11/2021,30.84,-115.28,3690160
Guanajuato,1510,Mexico,141704,11215,130489,08/11/2021,21.02,-101.26,6280645
Puebla,1511,Mexico,94393,12588,81805,08/11/2021,19.04,-98.21,6664764
Veracruz,1512,Mexico,86359,10972,75387,08/11/2021,19.17,-96.13,1395545
Chiapas,1513,Mexico,16496,1833,14663,08/11/2021,16.76,-93.13,5812375
Yucatan,1514,Mexico,56028,4651,51377,08/11/2021,20.71,-89.09,8588469
San Luis Potosi,1515,Mexico,75220,5564,69656,08/11/2021,22.16,-100.99,1761389
Zacatecas,1516,Mexico,34525,2954,31571,08/11/2021,22.77,-102.58,1677911
Aguascalientes,1517,Mexico,28596,2504,26092,08/11/2021,21.89,-102.29,1453452
Hidalgo,1518,Mexico,46841,6534,40307,08/11/2021,20.09,-98.76,3121355
Queretaro,1519,Mexico,75823,4625,71198,08/11/2021,20.59,-100.39,6664764
Chihuahua,1520,Mexico,61004,7676,53328,08/11/2021,28.63,-106.07,3836506
Michoacan,1521,Mexico,56560,6300,50260,08/11/2021,19.57,-101.71,8490806
Ciudad de Mexico,1522,Mexico,817561,36171,781390,08/11/2021,19.43,-99.13,3836506
Baja California Sur,1523,Mexico,50816,2059,48757,08/11/2021,26.04,-111.67,821059
Tlaxcala,1524,Mexico,22071,2622,19449,08/11/2021,19.31,-98.24,1395545
Campeche,1525,Mexico,15761,1511,14250,08/11/2021,19.83,-90.53,1017011
Coahuila,1526,Mexico,75048,6588,68460,08/11/2021,27.06,-101.71,9003827
Colima,1527,Mexico,18466,1307,17159,08/11/2021,19.12,-104.01,797245
Oaxaca,1528,Mexico,57849,4233,53616,08/11/2021,17.07,-96.73,4165619
Mexico,1529,Mexico,304869,38842,266027,08/11/2021,19.5,-99.72,8490806
Sonora,1530,Mexico,91887,7135,84752,08/11/2021,29.3,-110.33,3111119
Tabasco,1531,Mexico,92364,4498,87866,08/11/2021,17.84,-92.62,2599658
Nuevo Leon,1532,Mexico,151191,10328,140863,08/11/2021,25.59,-100,1306145
Guerrero,1533,Mexico,56725,4992,51733,08/11/2021,17.44,-99.55,3668973
Quintana Roo,1534,Mexico,46785,3418,43367,08/11/2021,19.18,-88.48,1761389
Nayarit,1535,Mexico,22314,2124,20190,08/11/2021,21.75,-104.85,1306145
Tamaulipas,1536,Mexico,75826,5575,70251,08/11/2021,24.27,-98.84,3679623
Nuevo Leon,1537,Mexico,152494,10391,142103,08/12/2021,25.59,-100,1306145
Michoacan,1538,Mexico,56992,6319,50673,08/12/2021,19.57,-101.71,8490806
Mexico,1539,Mexico,306703,38949,267754,08/12/2021,19.5,-99.72,8490806
Tlaxcala,1540,Mexico,22202,2622,19580,08/12/2021,19.31,-98.24,1395545
Veracruz,1541,Mexico,86926,11014,75912,08/12/2021,19.17,-96.13,1395545
Sinaloa,1542,Mexico,61463,7267,54196,08/12/2021,25.17,-107.48,3181609
Durango,1543,Mexico,39510,2579,36931,08/12/2021,24.56,-104.66,1884622
Yucatan,1544,Mexico,56275,4661,51614,08/12/2021,20.71,-89.09,8588469
Hidalgo,1545,Mexico,47258,6557,40701,08/12/2021,20.09,-98.76,3121355
Aguascalientes,1546,Mexico,28746,2516,26230,08/12/2021,21.89,-102.29,1453452
Quintana Roo,1547,Mexico,47155,3428,43727,08/12/2021,19.18,-88.48,1761389
San Luis Potosi,1548,Mexico,76002,5569,70433,08/12/2021,22.16,-100.99,1761389
Baja California Sur,1549,Mexico,51019,2069,48950,08/12/2021,26.04,-111.67,821059
Coahuila,1550,Mexico,75379,6592,68787,08/12/2021,27.06,-101.71,9003827
Nayarit,1551,Mexico,22784,2144,20640,08/12/2021,21.75,-104.85,1306145
Tamaulipas,1552,Mexico,76313,5589,70724,08/12/2021,24.27,-98.84,3679623
Guerrero,1553,Mexico,57502,5019,52483,08/12/2021,17.44,-99.55,3668973
Jalisco,1554,Mexico,114281,13517,100764,08/12/2021,20.66,-103.35,8490806
Campeche,1555,Mexico,15865,1516,14349,08/12/2021,19.83,-90.53,1017011
Colima,1556,Mexico,18909,1321,17588,08/12/2021,19.12,-104.01,797245
Puebla,1557,Mexico,94890,12620,82270,08/12/2021,19.04,-98.21,6664764
Queretaro,1558,Mexico,76190,4645,71545,08/12/2021,20.59,-100.39,6664764
Oaxaca,1559,Mexico,58348,4245,54103,08/12/2021,17.07,-96.73,4165619
Baja California,1560,Mexico,53646,8950,44696,08/12/2021,30.84,-115.28,3690160
Guanajuato,1561,Mexico,142325,11225,131100,08/12/2021,21.02,-101.26,6280645
Chiapas,1562,Mexico,16679,1839,14840,08/12/2021,16.76,-93.13,5812375
Morelos,1563,Mexico,38423,3691,34732,08/12/2021,18.68,-99.1,2065014
Ciudad de Mexico,1564,Mexico,822336,36290,786046,08/12/2021,19.43,-99.13,3836506
Zacatecas,1565,Mexico,34689,2963,31726,08/12/2021,22.77,-102.58,1677911
Tabasco,1566,Mexico,93138,4517,88621,08/12/2021,17.84,-92.62,2599658
Chihuahua,1567,Mexico,61158,7689,53469,08/12/2021,28.63,-106.07,3836506
Sonora,1568,Mexico,92285,7163,85122,08/12/2021,29.3,-110.33,3111119
